#######
#     #
# #####
#   # #
# ### #
# ### #
#     #
#######