#######
# s   #
# #####
#   #G#
# ### #
# ### #
#     #
#######